11112222
11112222
11112222
11222222
32234444
22334444
22442222
44222222